Freddie	Mcbride
Troy	Flores
Glen	Soto
Lamar	Cummings
Leslie	Clayton
Marc	Gonzales
Kent	Cohen
Ervin	Weber
Malcolm	Owen
Adrian	Figueroa
Angelina	Bowman
Jeremy	Bass
Terrell	Lucas
Jesse	Sims
Carla	Watson
Ken	Bush
Nora	Rhodes
Evelyn	Flowers
Frances	Mason
Orville	Tran
Rosemarie	Hogan
Elsie	Nunez
Raymond	Wright
Bobby	Sullivan
Tami	Marsh
Rachael	Rowe
Bobbie	Harmon
Marvin	Coleman
Dave	Bailey
Gregg	Oliver
Mark	Sharp
Marshall	Newman
Lydia	Obrien
Rosie	Mills
Tamara	Hines
Shirley	Perez
Marie	Miller
Victoria	Jordan
Ollie	Colon
Renee	Bryant
Jack	Taylor
Sally	Walters
Maria	Walsh
Alfredo	Adkins
Michele	Cox
Leland	Parker
Brent	Cooper
Lucy	Roberson
Raquel	Mclaughlin
Martha	Webster
Andrea	Montgomery
Travis	Martin
Diana	Lawrence
Homer	Perkins
Carlos	Moody
Rose	Estrada
Elijah	Hampton
Natasha	Day
Terry	Robertson
Kelli	Arnold
Leroy	Mathis
Cary	Brown
Dale	Bates
Camille	Mack
Marco	Summers
Colin	Fuller
Roberta	Armstrong
Violet	Williams
William	Mcdonald
Patrick	Houston
Amber	Griffin
Monica	Stanley
Arthur	Reyes
Tomas	Lowe
Joan	Mckinney
Elizabeth	Kim
Betty	Schmidt
Delia	Crawford
Sara	Lynch
Paulette	Drake
Patty	Burton
Teri	Hansen
Cynthia	Gordon
Lorena	Harper
Tammy	Moore
Kelvin	James
Ignacio	Black
Randolph	Lambert
Louise	Craig
Marsha	Lloyd
Herman	Hunter
Lynn	Mitchell
Mildred	Kelley
Marion	Zimmerman
Everett	Phillips
Julian	Clarke
Patti	Myers
Laverne	Rodgers
Wilbert	Porter
Erika	Bridges
